16
0 3 0 1 30
6 3 5 6 1
3 5 1 3 3
4 4 4 3 3
1 3 4 3 3
1 5 2 3 3
6 5 2 3 3
1 3 2 2 4
3 4 2 6 1
1 3 1 3 3
1 3 5 10 0
3 1 5 3 3
6 6 2 3 3
1 6 2 2 3
5 3 1 3 3
6 2 3 3 3