14
3 0 0 3 3
1 1 0 3 3
5 1 0 3 3
3 3 0 3 3
1 5 0 3 3
5 5 0 3 3
3 6 0 3 3
0 2 3 3 3
6 2 3 3 3
2 3 3 3 3
3 3 3 3 3
4 3 3 3 3
0 4 3 3 3
6 4 3 3 3
