17
1 2 1 3 3
0 3 0 3 3
8 3 5 3 3
2 5 1 3 3
4 4 4 3 3
1 3 7 3 3
1 5 6 3 3
7 7 7 3 3
7 9 2 3 3
3 4 9 3 3
1 9 1 3 3
1 3 5 3 3
3 1 5 3 3
7 7 2 3 3
1 6 2 3 3
5 3 1 3 3
6 8 3 3 3