12
6 4 6 40 150 0 0 0 0 0 0 0
3 3 3 50 50 0 0 0 0 0 0 0
5 4 4 100 200 0 0 0 0 0 0 0
4 6 4 30 70 0 0 0 0 0 0 0
2 3 0 20 20 0 0 0 0 0 0 0
2 2 1 100 20 0 0 0 0 0 0 0
4 2 2 30 70 0 0 0 0 0 0 0
4 3 2 60 60 0 0 0 0 0 0 0
1 2 1 200 100 0 0 0 0 0 0 0
0 5 5 20 40 0 0 0 0 0 0 0
1 6 4 10 30 0 0 0 0 0 0 0
5 1 4 40 70 0 0 0 0 0 0 0